ID,termin,czech,math,school,"Body
ZÅ grades",Celkem,Poradi
75,1,49,50,99,12,111,1
76,1,30,25,55,12,67,234
77,1,30,21,51,12,63,259
78,2,40,44,84,12,96,42
79,2,46,34,80,12,92,77
80,2,21,6,27,5,32,415
81,1,39,26,65,12,77,174
84,2,18,11,29,11,40,396
85,2,44,45,89,12,101,28.-30.
86,2,48,45,93,12,105,11
89,2,35,41,76,12,88,100
91,1,28,28,56,12,68,228
92,2,18,29,47,11,58,293
93,2,31,14,45,12,57,302
94,1,44,32,76,12,88,107
95,2,41,38,79,12,91,80.-81.
97,2,41,38,79,12,91,80.-81.
99,2,20,19,39,12,51,350
100,1,19,17,36,12,48,363
101,2,42,29,71,12,83,134.-135.
102,2,46,49,95,12,107,6
103,1,19,15,34,11,45,376
104,2,36,27,63,11,74,189
105,2,22,22,44,10,54,325
106,2,49,47,96,12,108,5
107,1,46,31,77,12,89,96.-97.
110,1,36,23,59,12,71,210.-211.
114,2,41,18,59,12,71,212
119,1,28,19,47,12,59,288.-290.
122,1,44,40,84,12,96,43.-44.
123,2,30,16,46,12,58,297
125,2,48,44,92,12,104,13
127,1,30,27,57,12,69,220
128,1,45,46,91,12,103,17.-18.
129,1,39,44,83,12,95,47
130,2,45,26,71,12,83,140
131,2,40,36,76,12,88,102.-103.
132,2,30,20,50,12,62,270.-271.
133,2,29,24,53,12,65,244
134,2,32,15,47,12,59,291
135,2,45,46,91,12,103,17.-18.
136,2,37,26,63,11,74,190
139,1,44,42,86,12,98,36
141,1,47,34,81,12,93,66
142,1,32,36,68,12,80,156
144,2,43,48,91,12,103,15
149,2,45,29,74,12,86,120
,,,,,,,
150,1,30,31,61,9,70,213
151,2,24,19,43,12,55,322
152,2,0,0,0,12,12,probÃ­hÃ¡ PÅ˜
153,1,27,19,46,12,58,295
154,1,43,46,89,12,101,26.-27.
155,1,35,42,77,12,89,93.-94.
156,2,39,30,69,7,76,175
157,2,29,29,58,12,70,215.-216.
158,2,44,37,81,12,93,65
159,2,32,22,54,12,66,239
160,1,46,40,86,12,98,38.-39.
161,2,22,14,36,12,48,365
162,2,44,27,71,12,83,136.-139.
164,2,21,28,49,11,60,278
165,2,42,47,89,12,101,25
166,1,37,33,70,12,82,146.-147.
168,2,27,48,75,12,87,110
169,2,32,33,65,11,76,176
170,2,33,21,54,8,62,263
171,2,30,33,63,12,75,183
172,2,48,31,79,12,91,84
174,2,38,22,60,12,72,206
175,2,44,30,74,12,86,119
176,1,12,15,27,5,32,414
177,2,49,37,86,12,98,40
178,1,30,32,62,12,74,191
179,2,38,33,71,12,83,133
180,1,24,6,30,12,42,391
181,2,23,18,41,2,43,382
182,2,16,7,23,6,29,426
183,2,16,25,41,12,53,331
184,1,44,45,89,12,101,28.-30.
186,1,42,39,81,12,93,64
187,2,41,34,75,12,87,114
188,2,37,38,75,12,87,111
189,1,36,42,78,10,88,98
190,2,17,39,56,11,67,232
191,2,35,33,68,12,80,157.-159.
192,1,13,8,21,10,31,421
196,1,24,17,41,12,53,334
197,1,22,32,54,12,66,238
198,1,46,30,76,12,88,108
199,2,39,25,64,12,76,180
200,2,44,27,71,12,83,136.-139.
201,1,17,24,41,12,53,332.-333.
202,2,27,15,42,11,53,330
203,1,37,21,58,12,70,218
204,1,21,27,48,8,56,304
205,2,42,36,78,12,90,90
206,1,37,24,61,12,73,200
212,1,48,48,96,12,108,3.-4.
213,2,35,32,67,8,75,182
,,,,,,,
214,1,35,23,58,12,70,217
217,1,34,36,70,12,82,144
218,1,35,38,73,12,85,122
219,1,47,44,91,12,103,19
220,1,20,14,34,7,41,393
221,1,25,37,62,9,71,207
222,1,34,37,71,12,83,129.-130.
223,1,22,17,39,8,47,367
224,2,49,45,94,12,106,10
230,1,33,11,44,12,56,316
231,1,34,19,53,11,64,250
232,2,21,17,38,7,45,374
233,2,30,24,54,11,65,242
234,2,36,35,71,12,83,131.-132.
235,2,43,37,80,12,92,73
236,2,28,24,52,6,58,292
237,2,27,21,48,12,60,281
238,2,31,12,43,12,55,323
239,2,46,37,83,12,95,55.-56.
240,2,29,21,50,12,62,268.-269.
241,2,45,35,80,12,92,75.-76.
242,2,27,9,36,9,45,375
245,1,40,39,79,12,91,78.-79.
246,2,8,22,30,4,34,411
247,1,34,37,71,12,83,129.-130.
248,1,42,29,71,12,83,134.-135.
249,1,13,25,38,9,47,368
250,1,27,24,51,12,63,258
251,2,44,36,80,12,92,74
252,2,24,20,44,12,56,312
254,1,45,37,82,12,94,59.-60.
255,1,44,34,78,12,90,92
256,1,33,31,64,12,76,179
257,1,13,7,20,10,30,424.-425.
258,1,13,12,25,10,35,409
263,2,19,6,25,7,32,416
264,1,26,23,49,12,61,272.-273.
265,2,16,19,35,9,44,378
268,2,27,24,51,6,57,299
271,2,21,10,31,10,41,394
277,1,0,0,0,12,12,probÃ­hÃ¡ PÅ˜
278,1,26,12,38,10,48,359
279,1,43,33,76,12,88,105.-106.
280,1,37,32,69,12,81,153
281,1,43,43,86,12,98,35
282,1,34,17,51,11,62,264
283,1,42,24,66,12,78,170.-171.
284,1,49,46,95,12,107,8
285,1,48,40,88,12,100,32
286,2,45,49,94,12,106,9
287,1,32,27,59,12,71,209
288,1,21,6,27,12,39,400
,,,,,,,
289,1,13,10,23,9,32,417
290,1,35,22,57,12,69,223
291,1,13,10,23,12,35,410
292,1,26,32,58,7,65,241
293,1,23,19,42,12,54,327
294,2,41,37,78,12,90,89
295,2,38,46,84,11,95,46
296,2,25,15,40,11,51,348
297,2,31,36,67,12,79,164
298,2,24,11,35,8,43,385
299,2,31,13,44,8,52,338
300,2,42,22,64,12,76,181
301,2,47,35,82,12,94,61
302,2,27,21,48,8,56,305
303,2,42,30,72,12,84,127
304,2,42,37,79,11,90,85
305,2,47,49,96,12,108,2
306,2,14,14,28,3,31,419
342,1,40,37,77,12,89,95
343,1,40,28,68,12,80,162
344,2,26,22,48,12,60,280
345,1,27,10,37,11,48,362
346,2,45,40,85,12,97,41
347,1,26,18,44,12,56,313.-314.
348,1,47,43,90,12,102,22
349,1,19,17,36,5,41,392
350,2,30,39,69,10,79,163
351,1,41,23,64,10,74,187
352,2,24,20,44,10,54,326
353,1,43,46,89,12,101,26.-27.
354,2,35,42,77,12,89,93.-94.
355,1,36,35,71,12,83,131.-132.
356,1,32,27,59,4,63,253
357,2,42,32,74,11,85,121
358,1,48,44,92,11,103,14
359,2,21,23,44,12,56,311
360,2,29,17,46,9,55,319
361,2,30,37,67,11,78,166
362,2,22,15,37,12,49,358
363,2,35,21,56,11,67,233
364,1,32,19,51,12,63,260.-261.
365,2,18,20,38,11,49,356
366,1,14,14,28,7,35,405
367,1,25,15,40,12,52,344
368,1,28,21,49,12,61,274
369,1,35,25,60,12,72,205
370,2,44,39,83,12,95,53
371,1,35,9,44,12,56,317
372,1,34,21,55,12,67,235
373,2,11,10,21,6,27,430
374,1,46,37,83,12,95,55.-56.
375,1,35,45,80,12,92,68
,,,,,,,
376,2,41,39,80,12,92,70.-71.
377,1,35,33,68,12,80,157.-159.
378,2,34,27,61,12,73,198.-199.
379,2,26,25,51,12,63,257
380,1,33,29,62,12,74,193
381,1,40,40,80,12,92,69
382,1,45,37,82,12,94,59.-60.
383,1,33,32,65,12,77,172.-173.
384,1,23,19,42,10,52,340
385,1,32,17,49,12,61,275
386,2,21,22,43,0,43,381
387,1,46,44,90,12,102,21
388,1,32,38,70,12,82,142
389,2,45,39,84,12,96,45
390,1,34,27,61,12,73,198.-199.
391,1,43,32,75,12,87,115
392,2,28,27,55,8,63,255
393,1,0,37,37,12,49,probÃ­hÃ¡ PÅ˜
394,1,44,27,71,12,83,136.-139.
395,1,26,23,49,12,61,272.-273.
396,1,37,35,72,12,84,124.-125.
397,2,37,39,76,10,86,116
398,1,32,28,60,11,71,208
399,2,21,16,37,0,37,402
400,1,46,46,92,12,104,12
401,2,47,26,73,11,84,123
402,2,27,29,56,12,68,227
403,2,48,42,90,12,102,23.-24.
404,2,30,20,50,4,54,324
405,2,23,18,41,11,52,343
406,2,30,27,57,11,68,225
407,1,24,21,45,7,52,336
408,1,25,18,43,8,51,346
409,1,38,31,69,12,81,154
410,2,34,24,58,6,64,247
411,2,43,33,76,12,88,105.-106.
412,2,26,19,45,11,56,310
413,1,37,35,72,12,84,124.-125.
414,2,20,21,41,11,52,342
415,2,36,25,61,11,72,202
416,2,39,26,65,11,76,178
428,2,42,41,83,12,95,50.-51.
429,2,45,35,80,12,92,75.-76.
430,1,24,20,44,11,55,320
431,2,45,38,83,12,95,54
432,1,18,17,35,7,42,388
433,2,39,23,62,12,74,195
434,2,31,31,62,11,73,196
435,1,16,11,27,6,33,413
436,1,42,33,75,11,86,117
437,1,29,25,54,10,64,248
438,1,31,35,66,12,78,167
,,,,,,,
439,2,22,13,35,11,46,371
440,2,23,27,50,9,59,284
441,1,48,48,96,12,108,3.-4.
442,1,20,15,35,8,43,384
443,1,39,29,68,12,80,160.-161.
444,2,32,37,69,11,80,155
445,1,30,23,53,6,59,283
446,2,26,20,46,12,58,294
447,1,35,36,71,10,81,150
448,2,26,19,45,4,49,352
449,2,19,12,31,12,43,387
450,1,28,19,47,12,59,288.-290.
451,1,35,33,68,12,80,157.-159.
452,1,46,43,89,12,101,31
453,1,42,41,83,12,95,50.-51.
454,1,43,40,83,12,95,52
455,1,44,45,89,12,101,28.-30.
456,2,38,43,81,12,93,62
457,2,46,31,77,12,89,96.-97.
458,1,19,28,47,9,56,306
459,2,17,10,27,8,35,406
460,2,41,34,75,12,87,112.-113.
480,2,28,24,52,12,64,252
481,2,27,17,44,5,49,353
482,1,39,39,78,12,90,86.-87.
483,2,41,35,76,12,88,104
484,2,18,19,37,11,48,360
485,2,17,30,47,10,57,300
486,2,36,36,72,11,83,128
487,1,33,32,65,12,77,172.-173.
488,1,21,23,44,9,53,329
489,2,43,39,82,12,94,58
490,2,24,13,37,11,48,361
491,2,30,44,74,12,86,118
492,2,8,15,23,11,34,412
493,2,0,0,0,10,10,probÃ­hÃ¡ PÅ˜
494,2,34,32,66,12,78,168.-169.
495,2,43,36,79,12,91,82
496,2,0,0,0,3,3,probÃ­hÃ¡ PÅ˜
497,2,31,26,57,11,68,226
498,2,19,15,34,9,43,386
499,2,30,35,65,9,74,185
500,2,41,34,75,12,87,112.-113.
501,1,21,27,48,7,55,318
502,1,25,27,52,8,60,277
503,2,35,35,70,12,82,145
504,2,10,1,11,2,13,434
505,2,23,24,47,12,59,287
506,1,36,34,70,11,81,151
507,2,30,18,48,12,60,282
508,2,26,24,50,12,62,266
509,1,17,24,41,12,53,332.-333.
,,,,,,,
510,1,39,39,78,12,90,86.-87.
511,1,20,12,32,12,44,380
512,2,25,23,48,12,60,279
513,1,29,21,50,12,62,268.-269.
514,1,33,20,53,12,65,245.-246.
515,1,0*,26,26,9,35,*250.
517,1,17,13,30,10,40,395
531,1,40,41,81,11,92,67
541,1,37,17,54,12,66,240
542,1,17,0,17,12,29,428
543,1,24,34,58,5,63,254
544,2,20,27,47,9,56,307
545,1,29,15,44,12,56,315
546,1,32,14,46,12,58,298
547,1,35,34,69,12,81,152
548,1,39,31,70,12,82,148.-149.
549,1,22,14,36,10,46,370
550,1,36,23,59,12,71,210.-211.
551,2,23,27,50,12,62,265
552,2,37,12,49,12,61,276
553,2,45,45,90,12,102,20
554,2,19,16,35,8,43,383
555,2,26,37,63,9,72,201
556,2,47,24,71,12,83,141
557,2,25,20,45,7,52,337
558,2,40,36,76,12,88,102.-103.
559,2,46,40,86,12,98,38.-39.
560,2,19,11,30,12,42,390
561,2,25,17,42,7,49,354
562,2,16,10,26,9,35,408
563,2,33,18,51,12,63,262
564,2,40,23,63,12,75,184
565,2,0,0,0,1,1,probÃ­hÃ¡ PÅ˜
566,2,33,20,53,12,65,245.-246.
567,2,40,39,79,12,91,78.-79.
568,2,48,42,90,12,102,23.-24.
569,2,37,27,64,10,74,186
570,2,15,17,32,12,44,379
571,2,21,15,36,12,48,364
572,2,36,26,62,12,74,194
573,2,20,28,48,11,59,285
574,2,43,35,78,12,90,91
575,2,37,33,70,12,82,146.-147.
576,2,16,14,30,12,42,389
577,1,13,15,28,7,35,404
578,1,41,31,72,12,84,126
579,1,28,33,61,12,73,197
580,1,32,27,59,11,70,214
581,1,44,27,71,12,83,136.-139.
582,2,21,17,38,8,46,369
583,1,38,38,76,12,88,101
584,1,26,18,44,12,56,313.-314.
,,,,,,,
585,1,30,15,45,12,57,301
586,1,27,20,47,9,56,308
587,1,32,20,52,11,63,256
588,1,45,41,86,12,98,37
589,1,34,23,57,9,66,236
590,1,16,13,29,10,39,399
591,1,19,14,33,12,45,377
592,1,32,19,51,12,63,260.-261.
593,1,36,31,67,12,79,165
594,1,11,12,23,8,31,420
595,1,40,43,83,12,95,48.-49.
596,1,23,13,36,12,48,366
597,1,9,6,15,1,16,433
598,1,44,47,91,12,103,16
599,1,34,22,56,12,68,230
600,1,12,9,21,9,30,423
601,1,41,39,80,12,92,70.-71.
602,1,0,0,0,12,12,probÃ­hÃ¡ PÅ˜
623,1,12,20,32,7,39,398
624,1,33,37,70,12,82,143
625,1,47,32,79,12,91,83
626,1,13,7,20,10,30,424.-425.
627,1,28,19,47,12,59,288.-290.
628,1,16,7,23,9,32,418
629,1,34,31,65,11,76,177
630,1,19,16,35,3,38,401
631,1,29,28,57,12,69,219
632,1,21,13,34,12,46,372
633,1,31,25,56,12,68,229
634,1,18,10,28,12,40,397
635,1,30,10,40,11,51,349
636,1,24,10,34,12,46,373
637,1,30,20,50,12,62,270.-271.
638,1,28,13,41,12,53,335
639,1,40,38,78,12,90,88
640,1,0,0,0,12,12,probÃ­hÃ¡ PÅ˜
641,1,31,31,62,12,74,192
642,1,29,11,40,12,52,345
643,1,14,8,22,7,29,427
644,1,40,41,81,12,93,63
645,1,40,43,83,12,95,48.-49.
646,1,18,34,52,12,64,251
647,1,20,23,43,12,55,321
648,1,39,29,68,12,80,160.-161.
649,1,18,11,29,6,35,403
650,2,39,31,70,12,82,148.-149.
651,2,27,23,50,12,62,267
652,2,34,42,76,12,88,99
653,2,26,23,49,7,56,303
654,2,28,25,53,11,64,249
655,2,42,38,80,12,92,72
656,2,28,14,42,10,52,341
,,,,,,,
657,2,32,25,57,12,69,221
658,2,39,43,82,12,94,57
659,2,34,32,66,12,78,168.-169.
660,2,11,8,19,12,31,422
661,2,13,8,21,7,28,429
662,2,32,16,48,11,59,286
663,2,44,32,76,11,87,109
664,2,14,28,42,10,52,339
665,2,47,40,87,12,99,33
666,2,44,40,84,12,96,43.-44.
667,2,29,29,58,12,70,215.-216.
668,2,40,18,58,10,68,224
669,2,24,21,45,5,50,351
672,1,22,33,55,11,66,237
673,1,30,16,46,7,53,328
674,1,33,13,46,10,56,309
675,1,10,4,14,8,22,432
676,1,48,47,95,12,107,7
677,2,27,26,53,12,65,243
678,2,42,24,66,12,78,170.-171.
679,2,28,11,39,10,49,355
680,2,29,35,64,3,67,231
681,2,29,31,60,12,72,204
682,2,25,35,60,12,72,203
683,2,35,28,63,11,74,188
684,2,33,24,57,12,69,222
685,2,5,9,14,8,22,431
689,1,37,49,86,12,98,34
690,2,26,17,43,8,51,347
691,2,29,17,46,12,58,296
