TODROP,RANK,ID,GRADES,MATH,CZECH,SUM,ADMITTED_ID,YEAR,SCHOOLCOURSE_ID
0,27,75,22,39,32,93,0,2018,381
1,28,138,22,36,35,93,0,2018,381
2,29,17,22,33,38,93,0,2018,381
3,30,275,22,32,39,93,0,2018,381
4,31,191,22,32,39,93,0,2018,381
5,32,262,22,30,41,93,0,2018,381
6,33,205,22,27,44,93,0,2018,381
7,34,41,22,37,33,92,0,2018,381
8,35,234,21,37,33,91,0,2018,381
9,36,287,22,35,34,91,0,2018,381
10,37,31,22,30,39,91,0,2018,381
11,38,135,22,27,42,91,0,2018,381
12,39,97,22,26,43,91,0,2018,381
13,40,26,22,36,32,90,0,2018,381
14,41,45,22,28,40,90,0,2018,381
15,42,37,22,33,34,89,0,2018,381
16,43,172,21,29,39,89,0,2018,381
17,44,139,22,24,43,89,0,2018,381
18,45,24,22,35,31,88,0,2018,381
19,46,118,18,34,36,88,0,2018,381
20,47,78,22,34,32,88,0,2018,381
21,48,107,21,33,34,88,0,2018,381
22,49,127,22,33,33,88,0,2018,381
23,50,201,22,29,37,88,0,2018,381
24,51,64,22,28,38,88,0,2018,381
25,52,25,22,27,39,88,0,2018,381
26,53,85,22,24,42,88,0,2018,381
27,54,57,20,32,35,87,0,2018,381
28,55,216,22,32,33,87,0,2018,381
29,56,263,22,28,37,87,0,2018,381
30,57,58,22,23,42,87,0,2018,381
31,58,27,22,32,32,86,0,2018,381
32,59,267,22,32,32,86,0,2018,381
33,60,120,22,32,32,86,0,2018,381
34,61,290,22,29,35,86,0,2018,381
35,62,174,22,32,31,85,0,2018,381
36,63,218,22,29,34,85,0,2018,381
37,64,241,22,31,31,84,0,2018,381
38,65,131,21,29,33,83,0,2018,381
39,66,103,21,28,34,83,0,2018,381
40,67,261,22,28,33,83,0,2018,381
41,68,175,22,27,34,83,0,2018,381
42,69,86,22,25,35,82,0,2018,381
43,70,192,22,23,37,82,0,2018,381
44,71,202,20,21,41,82,0,2018,381
45,72,185,18,35,28,81,0,2018,381
46,73,16,22,34,25,81,0,2018,381
47,74,128,22,29,30,81,0,2018,381
48,75,162,22,28,31,81,0,2018,381
49,76,98,22,22,37,81,0,2018,381
50,77,65,22,19,40,81,0,2018,381
51,78,246,22,32,26,80,0,2018,381
52,79,298,19,29,32,80,0,2018,381
53,80,193,22,29,29,80,0,2018,381
54,81,73,20,27,33,80,0,2018,381
55,82,156,21,27,32,80,0,2018,381
56,83,258,22,20,38,80,0,2018,381
57,84,165,22,31,26,79,0,2018,381
58,85,164,21,28,30,79,0,2018,381
59,86,212,21,26,32,79,0,2018,381
60,87,208,21,33,24,78,0,2018,381
61,88,222,21,28,29,78,0,2018,381
62,89,140,22,26,30,78,0,2018,381
63,90,76,22,20,36,78,0,2018,381
64,91,264,17,30,30,77,0,2018,381
65,92,104,22,24,31,77,0,2018,381
66,93,87,22,23,32,77,0,2018,381
67,94,245,22,29,25,76,0,2018,381
68,95,302,18,28,30,76,0,2018,381
69,96,251,21,27,28,76,0,2018,381
70,97,173,21,22,33,76,0,2018,381
71,98,161,21,17,38,76,0,2018,381
72,99,273,21,30,24,75,0,2018,381
73,100,282,21,27,27,75,0,2018,381
74,101,53,21,23,31,75,0,2018,381
75,102,266,22,22,31,75,0,2018,381
76,103,206,22,21,32,75,0,2018,381
77,104,32,22,19,34,75,0,2018,381
78,105,133,22,19,34,75,0,2018,381
79,106,272,20,25,29,74,0,2018,381
80,107,278,22,23,29,74,0,2018,381
81,108,125,22,23,29,74,0,2018,381
82,109,111,22,22,30,74,0,2018,381
83,110,54,21,20,33,74,0,2018,381
84,111,255,22,20,31,73,0,2018,381
85,112,215,20,23,29,72,0,2018,381
86,113,137,22,22,28,72,0,2018,381
87,114,265,20,19,33,72,0,2018,381
88,115,190,22,19,31,72,0,2018,381
89,116,113,20,24,27,71,0,2018,381
90,117,248,20,22,29,71,0,2018,381
91,118,66,22,19,30,71,0,2018,381
92,119,214,21,38,11,70,0,2018,381
93,120,109,19,24,27,70,0,2018,381
94,121,210,21,24,25,70,0,2018,381
95,122,184,20,22,28,70,0,2018,381
96,123,70,21,22,27,70,0,2018,381
97,124,123,22,22,26,70,0,2018,381
98,125,44,22,17,31,70,0,2018,381
99,126,168,21,15,34,70,0,2018,381
100,127,72,21,14,35,70,0,2018,381
101,128,158,22,22,25,69,0,2018,381
102,129,90,18,18,33,69,0,2018,381
103,130,296,21,16,32,69,0,2018,381
104,131,238,21,14,34,69,0,2018,381
105,132,183,22,13,34,69,0,2018,381
106,133,163,15,29,24,68,0,2018,381
107,134,188,21,16,31,68,0,2018,381
108,135,279,22,16,30,68,0,2018,381
109,136,80,22,15,31,68,0,2018,381
110,137,232,19,23,25,67,0,2018,381
111,138,199,22,23,22,67,0,2018,381
112,139,200,22,22,23,67,0,2018,381
113,140,292,20,21,26,67,0,2018,381
114,141,257,22,17,28,67,0,2018,381
115,142,256,21,16,30,67,0,2018,381
116,143,35,22,16,29,67,0,2018,381
117,144,69,18,26,22,66,0,2018,381
118,145,213,22,25,19,66,0,2018,381
119,146,260,22,20,24,66,0,2018,381
120,147,220,22,19,25,66,0,2018,381
121,148,281,22,19,25,66,0,2018,381
122,149,283,22,24,19,65,0,2018,381
123,150,56,20,22,23,65,0,2018,381
124,151,187,21,21,23,65,0,2018,381
125,152,166,22,18,25,65,0,2018,381
126,153,119,22,18,25,65,0,2018,381
127,154,286,22,23,19,64,0,2018,381
128,155,159,21,17,26,64,0,2018,381
129,156,204,22,16,26,64,0,2018,381
130,157,124,21,15,28,64,0,2018,381
131,158,300,22,25,16,63,0,2018,381
132,159,145,21,19,23,63,0,2018,381
133,160,299,21,17,25,63,0,2018,381
134,161,59,20,14,29,63,0,2018,381
135,162,186,22,11,30,63,0,2018,381
136,163,189,20,22,20,62,0,2018,381
137,164,244,19,21,21,61,0,2018,381
138,165,141,22,16,23,61,0,2018,381
139,166,126,20,11,30,61,0,2018,381
140,167,100,22,10,29,61,0,2018,381
141,168,42,21,19,20,60,0,2018,381
142,169,239,19,14,27,60,0,2018,381
143,170,81,22,13,25,60,0,2018,381
144,171,171,20,22,16,58,0,2018,381
145,172,301,19,18,21,58,0,2018,381
146,173,18,20,14,24,58,0,2018,381
147,174,60,21,13,24,58,0,2018,381
148,175,207,21,11,26,58,0,2018,381
149,176,34,19,17,21,57,0,2018,381
150,177,254,16,16,25,57,0,2018,381
151,178,198,21,18,17,56,0,2018,381
152,179,77,16,14,26,56,0,2018,381
153,180,235,21,13,22,56,0,2018,381
154,181,194,20,12,24,56,0,2018,381
155,182,101,21,12,23,56,0,2018,381
156,183,294,21,6,29,56,0,2018,381
157,184,237,20,16,19,55,0,2018,381
158,185,277,18,14,23,55,0,2018,381
159,186,110,22,14,19,55,0,2018,381
160,187,243,16,18,20,54,0,2018,381
161,188,293,17,15,22,54,0,2018,381
162,189,83,22,14,18,54,0,2018,381
163,190,250,20,12,22,54,0,2018,381
164,191,121,19,19,15,53,0,2018,381
165,192,102,18,14,21,53,0,2018,381
166,193,274,18,16,18,52,0,2018,381
167,194,240,21,16,15,52,0,2018,381
168,195,209,22,16,14,52,0,2018,381
169,196,82,21,13,16,50,0,2018,381
170,197,236,17,10,23,50,0,2018,381
171,198,242,22,7,21,50,0,2018,381
172,199,252,13,14,22,49,0,2018,381
173,200,182,20,14,15,49,0,2018,381
174,201,285,22,14,12,48,0,2018,381
175,202,129,17,13,18,48,0,2018,381
176,203,280,17,13,18,48,0,2018,381
177,204,203,20,15,12,47,0,2018,381
178,205,259,20,8,19,47,0,2018,381
179,206,99,21,8,18,47,0,2018,381
180,207,142,22,9,14,45,0,2018,381
181,208,295,18,8,19,45,0,2018,381
182,209,217,19,8,18,45,0,2018,381
183,210,196,17,7,21,45,0,2018,381
184,211,79,21,7,16,44,0,2018,381
185,212,84,20,15,8,43,0,2018,381
186,213,132,19,7,17,43,0,2018,381
187,214,157,21,11,10,42,0,2018,381
188,215,249,1,23,17,41,0,2018,381
189,216,195,12,17,10,39,0,2018,381
190,217,88,19,8,12,39,0,2018,381
191,218,67,12,14,11,37,0,2018,381
192,219,68,15,13,9,37,0,2018,381
193,220,291,9,13,14,36,0,2018,381
194,221,46,17,12,7,36,0,2018,381
195,222,47,15,9,11,35,0,2018,381
196,223,30,17,6,12,35,0,2018,381
197,224,167,19,6,8,33,0,2018,381
198,225,276,20,2,10,32,0,2018,381
199,226,134,17,5,8,30,0,2018,381
200,227,297,9,9,9,27,0,2018,381
201,228,136,-2,7,15,20,0,2018,381
202,229,144,-20,5,10,-5,0,2018,381
203,1,197,22,42,48,112,1,2018,381
204,2,36,22,44,45,111,1,2018,381
205,3,253,22,41,48,111,1,2018,381
206,4,112,22,45,43,110,1,2018,381
207,5,284,22,44,44,110,1,2018,381
208,6,71,22,43,43,108,1,2018,381
209,7,288,21,41,45,107,1,2018,381
210,8,106,22,38,47,107,1,2018,381
211,9,160,22,46,38,106,1,2018,381
212,10,43,22,40,43,105,1,2018,381
213,11,74,22,42,40,104,1,2018,381
214,12,33,22,40,41,103,1,2018,381
215,13,122,22,40,41,103,1,2018,381
216,14,89,22,42,37,101,1,2018,381
217,15,105,22,38,41,101,1,2018,381
218,16,38,22,36,43,101,1,2018,381
219,17,108,22,39,39,100,1,2018,381
220,18,170,21,38,39,98,1,2018,381
221,19,148,22,34,42,98,1,2018,381
222,20,231,22,38,37,97,1,2018,381
223,21,289,22,36,39,97,1,2018,381
224,22,233,22,41,33,96,1,2018,381
225,23,211,22,39,35,96,1,2018,381
226,24,169,22,37,37,96,1,2018,381
227,25,55,22,34,39,95,1,2018,381
228,26,143,22,28,44,94,1,2018,381
