RANK,ID,GRADES,MATH,CZECH,SUM,ADMITTED_ID
27,75,22,39,32,93,0
28,138,22,36,35,93,0
29,17,22,33,38,93,0
30,275,22,32,39,93,0
31,191,22,32,39,93,0
32,262,22,30,41,93,0
33,205,22,27,44,93,0
34,41,22,37,33,92,0
35,234,21,37,33,91,0
36,287,22,35,34,91,0
37,31,22,30,39,91,0
38,135,22,27,42,91,0
39,97,22,26,43,91,0
40,26,22,36,32,90,0
41,45,22,28,40,90,0
42,37,22,33,34,89,0
43,172,21,29,39,89,0
44,139,22,24,43,89,0
45,24,22,35,31,88,0
46,118,18,34,36,88,0
47,78,22,34,32,88,0
48,107,21,33,34,88,0
49,127,22,33,33,88,0
50,201,22,29,37,88,0
51,64,22,28,38,88,0
52,25,22,27,39,88,0
53,85,22,24,42,88,0
54,57,20,32,35,87,0
55,216,22,32,33,87,0
56,263,22,28,37,87,0
57,58,22,23,42,87,0
58,27,22,32,32,86,0
59,267,22,32,32,86,0
60,120,22,32,32,86,0
61,290,22,29,35,86,0
62,174,22,32,31,85,0
63,218,22,29,34,85,0
64,241,22,31,31,84,0
65,131,21,29,33,83,0
66,103,21,28,34,83,0
67,261,22,28,33,83,0
68,175,22,27,34,83,0
69,86,22,25,35,82,0
70,192,22,23,37,82,0
71,202,20,21,41,82,0
72,185,18,35,28,81,0
73,16,22,34,25,81,0
74,128,22,29,30,81,0
75,162,22,28,31,81,0
76,98,22,22,37,81,0
77,65,22,19,40,81,0
78,246,22,32,26,80,0
79,298,19,29,32,80,0
80,193,22,29,29,80,0
81,73,20,27,33,80,0
82,156,21,27,32,80,0
83,258,22,20,38,80,0
84,165,22,31,26,79,0
85,164,21,28,30,79,0
86,212,21,26,32,79,0
87,208,21,33,24,78,0
88,222,21,28,29,78,0
89,140,22,26,30,78,0
90,76,22,20,36,78,0
91,264,17,30,30,77,0
92,104,22,24,31,77,0
93,87,22,23,32,77,0
94,245,22,29,25,76,0
95,302,18,28,30,76,0
96,251,21,27,28,76,0
97,173,21,22,33,76,0
98,161,21,17,38,76,0
99,273,21,30,24,75,0
100,282,21,27,27,75,0
101,53,21,23,31,75,0
102,266,22,22,31,75,0
103,206,22,21,32,75,0
104,32,22,19,34,75,0
105,133,22,19,34,75,0
106,272,20,25,29,74,0
107,278,22,23,29,74,0
108,125,22,23,29,74,0
109,111,22,22,30,74,0
110,54,21,20,33,74,0
111,255,22,20,31,73,0
112,215,20,23,29,72,0
113,137,22,22,28,72,0
114,265,20,19,33,72,0
115,190,22,19,31,72,0
116,113,20,24,27,71,0
117,248,20,22,29,71,0
118,66,22,19,30,71,0
119,214,21,38,11,70,0
120,109,19,24,27,70,0
121,210,21,24,25,70,0
122,184,20,22,28,70,0
123,70,21,22,27,70,0
124,123,22,22,26,70,0
125,44,22,17,31,70,0
126,168,21,15,34,70,0
127,72,21,14,35,70,0
128,158,22,22,25,69,0
129,90,18,18,33,69,0
130,296,21,16,32,69,0
131,238,21,14,34,69,0
132,183,22,13,34,69,0
133,163,15,29,24,68,0
134,188,21,16,31,68,0
135,279,22,16,30,68,0
136,80,22,15,31,68,0
137,232,19,23,25,67,0
138,199,22,23,22,67,0
139,200,22,22,23,67,0
140,292,20,21,26,67,0
141,257,22,17,28,67,0
142,256,21,16,30,67,0
143,35,22,16,29,67,0
144,69,18,26,22,66,0
145,213,22,25,19,66,0
146,260,22,20,24,66,0
147,220,22,19,25,66,0
148,281,22,19,25,66,0
149,283,22,24,19,65,0
150,56,20,22,23,65,0
151,187,21,21,23,65,0
152,166,22,18,25,65,0
153,119,22,18,25,65,0
154,286,22,23,19,64,0
155,159,21,17,26,64,0
156,204,22,16,26,64,0
157,124,21,15,28,64,0
158,300,22,25,16,63,0
159,145,21,19,23,63,0
160,299,21,17,25,63,0
161,59,20,14,29,63,0
162,186,22,11,30,63,0
163,189,20,22,20,62,0
164,244,19,21,21,61,0
165,141,22,16,23,61,0
166,126,20,11,30,61,0
167,100,22,10,29,61,0
168,42,21,19,20,60,0
169,239,19,14,27,60,0
170,81,22,13,25,60,0
171,171,20,22,16,58,0
172,301,19,18,21,58,0
173,18,20,14,24,58,0
174,60,21,13,24,58,0
175,207,21,11,26,58,0
176,34,19,17,21,57,0
177,254,16,16,25,57,0
178,198,21,18,17,56,0
179,77,16,14,26,56,0
180,235,21,13,22,56,0
181,194,20,12,24,56,0
182,101,21,12,23,56,0
183,294,21,6,29,56,0
184,237,20,16,19,55,0
185,277,18,14,23,55,0
186,110,22,14,19,55,0
187,243,16,18,20,54,0
188,293,17,15,22,54,0
189,83,22,14,18,54,0
190,250,20,12,22,54,0
191,121,19,19,15,53,0
192,102,18,14,21,53,0
193,274,18,16,18,52,0
194,240,21,16,15,52,0
195,209,22,16,14,52,0
196,82,21,13,16,50,0
197,236,17,10,23,50,0
198,242,22,7,21,50,0
199,252,13,14,22,49,0
200,182,20,14,15,49,0
201,285,22,14,12,48,0
202,129,17,13,18,48,0
203,280,17,13,18,48,0
204,203,20,15,12,47,0
205,259,20,8,19,47,0
206,99,21,8,18,47,0
207,142,22,9,14,45,0
208,295,18,8,19,45,0
209,217,19,8,18,45,0
210,196,17,7,21,45,0
211,79,21,7,16,44,0
212,84,20,15,8,43,0
213,132,19,7,17,43,0
214,157,21,11,10,42,0
215,249,1,23,17,41,0
216,195,12,17,10,39,0
217,88,19,8,12,39,0
218,67,12,14,11,37,0
219,68,15,13,9,37,0
220,291,9,13,14,36,0
221,46,17,12,7,36,0
222,47,15,9,11,35,0
223,30,17,6,12,35,0
224,167,19,6,8,33,0
225,276,20,2,10,32,0
226,134,17,5,8,30,0
227,297,9,9,9,27,0
228,136,-2,7,15,20,0
229,144,-20,5,10,-5,0
1,197,22,42,48,112,1
2,36,22,44,45,111,1
3,253,22,41,48,111,1
4,112,22,45,43,110,1
5,284,22,44,44,110,1
6,71,22,43,43,108,1
7,288,21,41,45,107,1
8,106,22,38,47,107,1
9,160,22,46,38,106,1
10,43,22,40,43,105,1
11,74,22,42,40,104,1
12,33,22,40,41,103,1
13,122,22,40,41,103,1
14,89,22,42,37,101,1
15,105,22,38,41,101,1
16,38,22,36,43,101,1
17,108,22,39,39,100,1
18,170,21,38,39,98,1
19,148,22,34,42,98,1
20,231,22,38,37,97,1
21,289,22,36,39,97,1
22,233,22,41,33,96,1
23,211,22,39,35,96,1
24,169,22,37,37,96,1
25,55,22,34,39,95,1
26,143,22,28,44,94,1
