
RANK,reg. číslo,čeština,matemat.,ZŠ,Celkem
1.,9064,432,432,100,964
2.,9101,414,432,100,946
3.,8241,405,432,100,937
4.,8175,432,405,100,937
5.,9048,423,396,100,919
6.-7.,8215,378,432,100,910
6.-7.,9112,378,432,100,910
8.,9019,369,432,100,901
9.,9164,378,423,100,901
10.,9034,387,414,100,901
11.,9089,414,387,100,901
12.,9046,369,423,100,892
13.,8217,423,369,100,892
14.-15.,8169,396,387,100,883
14.-15.,9235,396,387,100,883
16.,9024,405,378,100,883
17.,8131,414,369,100,883
18.,8120,441,342,100,883
19.,9072,450,351,77,878
20.-21.,9127,387,387,100,874
20.-21.,8184,387,387,100,874
22.,8084,414,360,100,874
23.,8178,369,396,100,865
24.,8173,378,387,100,865
25.,8103,396,369,100,865
26.,9204,423,369,64,856
27.,9239,423,333,100,856
28.,9020,360,387,100,847
29.,8043,387,360,100,847
30.,9223,333,405,100,838
31.-33.,9246,360,378,100,838
31.-33.,9092,360,378,100,838
31.-33.,9177,360,378,100,838
34.,9011,387,351,100,838
35.-37.,8159,405,333,100,838
35.-37.,8253,405,333,100,838
35.-37.,9062,405,333,100,838
38.,8019,369,360,100,829
39.-40.,9068,387,342,100,829
39.-40.,8151,387,342,100,829
41.-42.,9039,405,324,100,829
41.-42.,8105,405,324,100,829
43.-44.,8251,351,369,100,820
43.-44.,9023,351,369,100,820
45.,8231,369,351,100,820
46.,8196,396,324,100,820
47.,9211,405,315,100,820
48.,9100,306,405,100,811
49.,9121,315,396,100,811
50.,8108,351,360,100,811
51.,8153,405,306,100,811
52.,9120,315,387,100,802
53.,9066,342,360,100,802
54.,8190,360,342,100,802
55.-56.,8107,378,324,100,802
55.-56.,9231,378,324,100,802
57.-58.,8205,396,306,100,802
57.-58.,9197,396,306,100,802
59.,9196,342,351,100,793
60.,9036,351,342,100,793
61.,8053,378,315,100,793
62.,8237,414,279,100,793
63.,9085,360,342,89,791
64.,8064,378,315,91,784
65.,8176,306,378,100,784
66.,9119,324,360,100,784
67.,9110,351,333,100,784
68.,9188,369,315,100,784
69.,9173,378,306,100,784
70.,8104,414,270,100,784
71.,9041,324,351,100,775
72.-74.,8111,333,342,100,775
72.-74.,9207,333,342,100,775
72.-74.,9042,333,342,100,775
75.,9143,342,333,100,775
76.,9251,351,324,100,775
77.,8174,360,315,100,775
78.,9144,297,369,100,766
79.,8056,306,360,100,766
80.-82.,8092,351,315,100,766
80.-82.,8136,351,315,100,766
80.-82.,8238,351,315,100,766
83.-85.,9056,378,288,100,766
83.-85.,8126,378,288,100,766
83.-85.,9194,378,288,100,766
86.,8046,306,351,100,757
87.,9242,315,342,100,757
88.,8061,324,333,100,757
89.,9187,333,324,100,757
90.,9097,351,306,100,757
91.,8044,369,288,100,757
92.,9086,378,279,100,757
93.,8155,297,351,100,748
94.,9212,333,315,100,748
95.-97.,8139,351,297,100,748
95.-97.,9146,351,297,100,748
95.-97.,8264,351,297,100,748
98.,8172,351,306,90,747
99.,9040,315,324,100,739
100.-101.,9133,324,315,100,739
100.-101.,9122,324,315,100,739
102.,8225,333,306,100,739
103.,8048,378,261,100,739
104.,8023,342,306,90,738
105.-106.,9209,324,306,100,730
105.-106.,9098,324,306,100,730
107.,8005,342,288,100,730
108.,8042,351,279,100,730
109.,9108,243,405,80,728
110.,8013,369,261,91,721
111.,8134,288,333,100,721
112.,8066,315,306,100,721
113.,8239,324,297,100,721
114.,8234,333,288,100,721
115.,8220,342,279,100,721
116.-117.,8050,378,243,100,721
116.-117.,8094,378,243,100,721
118.,8036,288,324,100,712
119.,9206,306,306,100,712
120.,9161,333,279,100,712
121.,8230,342,270,100,712
122.,8018,351,261,100,712
123.,8185,360,252,100,712
124.,8098,288,315,100,703
125.,8164,306,297,100,703
126.,8127,369,234,100,703
127.,8219,387,216,100,703
128.,8035,396,207,100,703
129.,9195,279,315,100,694
130.,8204,315,279,100,694
131.,9156,324,270,100,694
132.-133.,8017,333,261,100,694
132.-133.,9224,333,261,100,694
134.,8257,387,207,100,694
135.,9076,306,306,80,692
136.,8093,297,306,82,685
137.,8124,270,315,100,685
138.,8187,279,306,100,685
139.,9245,315,270,100,685
140.-141.,8028,333,252,100,685
140.-141.,9053,333,252,100,685
142.,8180,360,225,100,685
143.,9071,369,216,100,685
144.,9057,387,198,100,685
145.,9221,324,279,80,683
146.-147.,8073,315,261,100,676
146.-147.,8256,315,261,100,676
148.,8051,279,306,90,675
149.-150.,8083,279,288,100,667
149.-150.,9105,279,288,100,667
151.-155.,8049,315,252,100,667
151.-155.,9185,315,252,100,667
151.-155.,8071,315,252,100,667
151.-155.,8146,315,252,100,667
151.-155.,8031,315,252,100,667
156.,8030,324,243,100,667
157.,8221,342,225,100,667
158.,8224,360,207,100,667
159.,9017,270,288,100,658
160.,9190,297,261,100,658
161.,8034,306,252,100,658
162.-163.,9073,315,243,100,658
162.-163.,9111,315,243,100,658
164.,9234,270,288,92,650
165.,8226,279,270,100,649
166.,9140,342,207,100,649
167.,9168,252,306,90,648
168.,9162,243,297,100,640
169.,9030,261,279,100,640
170.,8254,279,261,100,640
171.,9015,288,252,100,640
172.,9050,306,234,100,640
173.,8167,315,225,100,640
174.,9198,333,207,100,640
175.,9243,342,198,100,640
176.,9215,351,189,100,640
177.,8130,279,270,90,639
178.,8014,288,270,80,638
179.,8168,261,306,70,637
180.,8012,297,252,87,636
181.,9079,279,306,50,635
182.,8045,243,288,100,631
183.-184.,8001,297,234,100,631
183.-184.,9081,297,234,100,631
185.-186.,9095,306,225,100,631
185.-186.,9208,306,225,100,631
187.,9069,324,207,100,631
188.,9006,252,270,100,622
189.-190.,8009,279,243,100,622
189.-190.,8216,279,243,100,622
191.-192.,8147,288,234,100,622
191.-192.,9192,288,234,100,622
193.,9106,324,198,100,622
194.,8248,369,153,100,622
195.,8102,261,270,90,621
196.,8263,351,180,90,621
197.,8117,297,234,82,613
198.,8149,234,279,100,613
199.,9002,252,261,100,613
200.,9226,270,243,100,613
201.-202.,9009,288,225,100,613
201.-202.,9222,288,225,100,613
203.,8002,306,207,100,613
204.,9170,252,279,80,611
205.,8060,306,216,89,611
206.,9078,342,198,70,610
207.,8161,261,243,100,604
208.,8121,279,225,100,604
209.-210.,9148,306,198,100,604
209.-210.,8052,306,198,100,604
211.,9233,225,297,80,602
212.,9094,243,252,100,595
213.,9037,261,234,100,595
214.-215.,9083,270,225,100,595
214.-215.,9174,270,225,100,595
216.,9175,279,216,100,595
217.,8142,288,207,100,595
218.-219.,8188,306,189,100,595
218.-219.,8154,306,189,100,595
220.,8040,351,180,60,591
221.,9165,279,225,87,591
222.,8058,243,279,67,589
223.,9202,279,234,75,588
224.,8229,333,180,73,586
225.,8158,207,279,100,586
226.,8006,261,225,100,586
227.,9047,270,216,100,586
228.,9240,297,189,100,586
229.,8072,252,252,80,584
230.,9132,198,288,91,577
231.-232.,8195,324,162,91,577
231.-232.,8192,324,162,91,577
233.,9004,216,261,100,577
234.,9093,288,189,100,577
235.,9244,297,198,80,575
236.,9060,261,225,89,575
237.,9157,315,189,70,574
238.,9167,315,189,67,571
239.,8096,297,198,73,568
240.,9178,180,288,100,568
241.,8265,198,270,100,568
242.-243.,8079,234,234,100,568
242.-243.,9253,234,234,100,568
244.,8037,315,153,100,568
245.,8197,180,306,80,566
246.,8245,288,207,70,565
247.,8115,315,180,64,559
248.-249.,9084,234,225,100,559
248.-249.,8085,234,225,100,559
250.,9080,252,207,100,559
251.,8106,279,180,100,559
252.-254.,8186,297,162,100,559
252.-254.,8249,297,162,100,559
252.-254.,9230,297,162,100,559
255.,9070,306,153,100,559
256.,8026,342,117,100,559
257.,9035,306,171,80,557
258.,8113,261,207,89,557
259.,9049,180,279,91,550
260.,9248,162,288,100,550
261.,8087,225,225,100,550
262.,8125,234,216,100,550
263.,8078,270,180,100,550
264.,9150,261,198,90,549
265.,9158,216,252,80,548
266.,9138,189,252,100,541
267.,9103,207,234,100,541
268.-269.,9139,234,207,100,541
268.-269.,8143,234,207,100,541
270.,8080,243,198,100,541
271.-272.,9116,261,180,100,541
271.-272.,8177,261,180,100,541
273.,8025,270,171,100,541
274.,8047,315,126,100,541
275.,8027,270,189,80,539
276.,9163,261,180,91,532
277.,9237,207,225,100,532
278.,8075,216,216,100,532
279.-280.,9025,243,189,100,532
279.-280.,9096,243,189,100,532
281.,8210,270,162,100,532
282.,9059,297,135,100,532
283.,8246,261,180,90,531
284.,8209,252,189,89,530
285.,9236,207,234,82,523
286.,8022,126,297,100,523
287.,9010,234,189,100,523
288.,8166,261,171,90,522
289.,9043,153,288,80,521
290.,9016,279,180,60,519
291.,9155,243,189,82,514
292.,9031,216,198,100,514
293.,8247,225,189,100,514
294.-295.,9125,279,135,100,514
294.-295.,9229,279,135,100,514
296.,9008,297,117,100,514
297.,9113,252,180,80,512
298.,9249,216,279,11,506
299.,8244,207,207,91,505
300.,9065,180,225,100,505
301.,9007,189,216,100,505
302.,9182,234,171,100,505
303.,8223,252,153,100,505
304.-305.,8004,288,117,100,505
304.-305.,8202,288,117,100,505
306.,9241,297,108,100,505
307.,9012,261,189,50,500
308.,9154,252,144,100,496
309.,8109,279,117,100,496
310.,9074,297,99,100,496
311.,8212,261,153,80,494
312.,9090,189,216,89,494
313.,8057,198,207,89,494
314.,9159,333,108,50,491
315.,8110,207,216,67,490
316.,8021,234,153,100,487
317.,9091,261,126,100,487
318.,8112,270,117,100,487
319.,8218,333,54,100,487
320.,9147,261,135,90,486
321.,9058,207,234,44,485
322.,9118,279,117,89,485
323.,9028,162,234,87,483
324.,8032,261,144,73,478
325.,9219,180,198,100,478
326.,8039,207,171,100,478
327.,9018,270,108,100,478
328.,8067,153,243,78,474
329.,8119,171,234,67,472
330.,8165,207,171,91,469
331.,9176,234,144,91,469
332.,9189,189,180,100,469
333.-334.,8089,207,162,100,469
333.-334.,9145,207,162,100,469
335.-336.,9232,225,144,100,469
335.-336.,9027,225,144,100,469
337.,9014,216,162,90,468
338.,8038,153,234,80,467
339.,8232,117,288,60,465
340.,8082,207,180,78,465
341.,9099,153,252,55,460
342.,8262,153,207,100,460
343.,8171,180,180,100,460
344.-345.,8063,198,162,100,460
344.-345.,9201,198,162,100,460
346.,8156,207,153,100,460
347.,8128,216,144,100,460
348.,9005,243,117,100,460
349.,8118,135,234,90,459
350.,8041,189,189,78,456
351.,8020,180,171,100,451
352.,8054,189,162,100,451
353.,9001,207,144,100,451
354.,9142,216,135,100,451
355.,9077,225,126,100,451
356.,8062,234,117,100,451
357.-358.,8194,243,108,100,451
357.-358.,9082,243,108,100,451
359.,9038,198,171,80,449
360.,9114,162,180,100,442
361.,8235,171,171,100,442
362.,8163,180,162,100,442
363.,8152,189,153,100,442
364.,9238,216,126,100,442
365.,8069,225,117,100,442
366.,9180,207,144,90,441
367.,9199,234,117,90,441
368.,9013,198,162,80,440
369.,8141,270,90,80,440
370.,9217,171,207,55,433
371.,8003,180,153,100,433
372.,9003,216,117,100,433
373.,8068,126,216,89,431
374.,9063,216,153,60,429
375.,9032,207,144,78,429
376.,8091,162,198,67,427
377.,8191,153,198,73,424
378.,8148,243,108,73,424
379.,8214,243,99,82,424
380.,8070,144,180,100,424
381.,8261,207,117,100,424
382.,8193,234,99,90,423
383.,8222,207,126,89,422
384.,9186,198,153,70,421
385.,8138,153,207,60,420
386.,8024,189,144,82,415
387.,8065,99,216,100,415
388.,9107,207,108,100,415
389.,8198,234,90,90,414
390.,9054,162,180,70,412
391.,8055,207,135,70,412
392.,9045,171,162,78,411
393.,8260,180,153,78,411
394.,8179,189,144,78,411
395.,8207,171,171,64,406
396.,9067,144,162,100,406
397.-398.,9123,171,135,100,406
397.-398.,9130,171,135,100,406
399.,8267,189,117,100,406
400.,8132,198,108,100,406
401.,8095,207,108,90,405
402.,9181,162,171,70,403
403.,8162,153,171,78,402
404.,9247,207,135,56,398
405.,9051,180,126,91,397
406.,9193,153,144,100,397
407.,9149,171,126,100,397
408.,8137,216,81,100,397
409.,9203,234,63,100,397
410.,8099,162,144,90,396
411.,9218,171,117,100,388
412.,8255,180,108,100,388
413.,9088,162,153,70,385
414.,9200,189,117,78,384
415.-416.,8227,135,144,100,379
415.-416.,8206,135,144,100,379
417.,8208,171,108,100,379
418.,9205,198,81,100,379
419.,9191,207,72,100,379
420.,9055,162,126,90,378
421.,9126,144,144,82,370
422.,8200,216,63,91,370
423.,8157,171,99,100,370
424.,8100,180,90,100,370
425.,9228,207,63,100,370
426.,8236,171,126,70,367
427.,9216,144,162,60,366
428.,9087,189,108,64,361
429.,9220,135,126,100,361
430.,9026,153,108,100,361
431.,8242,153,117,90,360
432.,9171,207,63,90,360
433.,9160,135,144,80,359
434.,9061,117,153,89,359
435.,9135,198,72,89,359
436.,9213,171,117,70,358
437.,8201,180,117,60,357
438.,8129,144,135,78,357
439.,8259,153,126,78,357
440.,9129,162,117,78,357
441.,9141,108,144,100,352
442.,8211,171,81,100,352
443.,8181,90,180,80,350
444.,9033,144,126,78,348
445.,9137,162,108,78,348
446.,8074,135,162,50,347
447.-448.,9044,144,99,100,343
447.-448.,9102,144,99,100,343
449.,8199,180,63,100,343
450.,8266,180,81,80,341
451.,8016,198,81,60,339
452.,8059,126,135,78,339
453.,8090,180,81,78,339
454.,9151,135,153,50,338
455.,8140,99,135,100,334
456.,8170,126,108,100,334
457.,9214,162,72,100,334
458.,9183,99,144,89,332
459.,8182,162,81,89,332
460.,9115,207,54,70,331
461.,8252,72,198,60,330
462.,8144,72,162,90,324
463.,8011,108,135,80,323
464.,8183,162,72,89,323
465.,9029,144,117,56,317
466.,8116,135,117,64,316
467.,9021,90,126,100,316
468.,8088,126,90,100,316
469.,8240,144,72,100,316
470.,9179,162,63,89,314
471.,9022,117,126,70,313
472.,8150,171,81,60,312
473.,8007,90,198,22,310
474.,9250,135,72,100,307
475.,8243,162,45,100,307
476.,8189,144,117,44,305
477.,8086,153,63,89,305
478.,9052,126,117,60,303
479.,8076,153,54,90,297
480.,9227,108,108,78,294
481.,8101,126,90,78,294
482.,9128,90,135,67,292
483.,8015,117,72,100,289
484.,8250,144,45,100,289
485.,9104,99,108,67,274
486.,8077,126,90,55,271
487.,8008,90,108,70,268
488.,9075,126,63,78,267
489.,8135,135,72,55,262
490.,8258,144,45,70,259
491.,8029,135,54,64,253
492.,8213,171,9,73,253
493.,9109,126,72,50,248
494.,9117,108,36,100,244
495.,8081,72,81,90,243
496.,8160,99,54,90,243
497.,8145,117,45,80,242
498.,8033,126,54,60,240
499.,8203,99,54,86,239
500.,8114,81,90,60,231
501.,8097,144,36,50,230
502.,9166,117,18,80,215
503.,9172,126,45,40,211
504.,9169,72,72,60,204
505.,9252,72,36,90,198
506.,9134,81,36,70,187
507.,9136,45,81,60,186
508.,9124,81,54,0,135