RANK,ID,GRADES,CONTESTS,CZECH,MATH,SUM
1,8279,20,4,47,50,121
2,8040,20,5,48,48,121
3,8013,20,3,47,46,116
4,8029,20,0,47,48,115
5,8120,20,0,48,47,115
6,8032,20,2,47,46,115
7,8060,20,3,46,46,115
8,8132,20,5,48,42,115
9,8115,20,0,46,48,114
10,8235,20,0,48,46,114
11,8239,20,2,46,46,114
12,8181,20,2,49,43,114
13,8223,20,0,47,46,113
14,8222,20,2,48,43,113
15,8076,19,0,44,49,112
16,8141,20,2,42,48,112
17,8073,20,0,44,47,111
18,8041,20,2,44,44,110
19,8050,20,5,44,41,110
20,8196,19,0,42,48,109
21,8183,20,2,43,44,109
22,8207,20,4,42,43,109
23,8023,20,0,48,41,109
24,8272,20,2,43,43,108
25,8090,20,0,46,42,108
26,8156,20,0,42,45,107
27,8038,20,0,44,43,107
28,8114,20,2,42,43,107
29,8119,20,0,45,42,107
30,8210,20,0,46,41,107
31,8080,20,0,38,48,106
32,8263,20,0,41,45,106
33,8051,20,0,43,43,106
34,8137,20,0,44,42,106
35,8140,20,2,43,41,106
36,8039,20,0,46,40,106
37,8065,20,2,46,38,106
38,8160,20,2,38,45,105
39,8296,20,0,46,39,105
40,8088,20,2,47,36,105
41,8004,20,0,40,44,104
42,8011,20,0,41,43,104
43,8005,20,0,44,40,104
44,8277,20,0,48,36,104
45,8055,20,2,47,35,104
46,8057,20,0,42,41,103
47,8019,20,0,43,40,103
48,8063,20,0,44,39,103
49,8109,20,2,45,36,103
50,8161,20,0,44,38,102
51,8215,20,0,46,36,102
52,8099,20,2,38,41,101
53,8087,20,0,46,35,101
54,8044,20,0,38,42,100
55,8048,18,0,41,41,100
56,8058,19,2,39,40,100
57,8174,20,2,38,40,100
58,8308,20,2,40,38,100
59,8166,20,0,43,37,100
60,8006,19,0,37,43,99
61,8297,20,0,38,41,99
62,8078,20,0,39,40,99
63,8246,19,0,42,38,99
64,8096,20,0,41,38,99
65,8046,20,2,42,35,99
66,8284,19,0,46,34,99
67,8027,20,0,34,44,98
68,8198,20,0,35,43,98
69,8028,18,0,40,40,98
70,8089,20,0,38,40,98
71,8110,20,0,39,39,98
72,8102,20,0,40,38,98
73,8154,20,2,38,38,98
74,8077,20,0,41,37,98
75,8155,20,0,42,36,98
76,8093,20,0,43,35,98
77,8220,19,0,37,41,97
78,8138,20,0,39,38,97
79,8159,20,0,40,37,97
80,8033,19,0,42,36,97
81,8108,20,0,44,33,97
82,8113,20,0,34,42,96
83,8047,20,0,35,41,96
84,8192,20,0,39,37,96
85,8075,20,0,43,33,96
86,8180,20,0,41,34,95
87,8101,20,2,41,32,95
88,8157,20,0,36,38,94
89,8195,20,0,37,37,94
90,8016,20,0,39,35,94
91,8165,20,0,39,35,94
92,8151,20,0,40,34,94
93,8118,20,0,43,31,94
94,8021,20,0,35,38,93
95,8008,20,4,32,37,93
96,8218,20,0,39,34,93
97,8261,20,2,30,40,92
98,8251,20,0,34,38,92
99,8007,20,0,34,38,92
100,8182,20,0,36,36,92
101,8208,20,2,34,36,92
102,8173,20,0,38,34,92
103,8278,20,0,39,33,92
104,8010,20,2,38,32,92
105,8091,20,0,43,29,92
106,8238,19,0,30,42,91
107,8237,20,0,29,42,91
108,8167,20,0,34,37,91
109,8273,19,0,36,36,91
110,8211,20,0,36,35,91
111,8124,20,2,35,34,91
112,8286,20,0,40,31,91
113,8252,19,0,43,29,91
114,8009,20,0,34,36,90
115,8197,20,0,35,35,90
116,8053,20,0,40,30,90
117,8067,20,0,41,29,90
118,8200,20,0,33,36,89
119,8214,20,0,35,34,89
120,8191,20,0,35,34,89
121,8162,20,0,36,33,89
122,8069,20,0,36,33,89
123,8022,20,0,37,32,89
124,8131,20,0,40,29,89
125,8307,20,0,35,33,88
126.-127.,8135,20,0,37,31,88
126.-127.,8262,20,0,37,31,88
128,8264,20,0,39,29,88
129,8015,20,0,27,40,87
130,8234,20,0,30,37,87
131,8139,20,0,35,32,87
132,8240,20,5,32,30,87
133,8036,19,0,39,29,87
134,8184,20,2,37,28,87
135,8128,19,0,30,37,86
136,8042,20,0,30,36,86
137,8130,19,0,35,32,86
138,8098,20,0,37,29,86
139,8291,20,0,38,28,86
140,8230,20,0,38,28,86
141,8275,20,0,34,31,85
142,8232,19,0,36,30,85
143,8204,20,2,33,30,85
144,8168,20,0,33,31,84
145,8256,20,0,36,28,84
146,8127,20,0,40,24,84
147,8107,18,0,29,36,83
148,8176,20,0,28,35,83
149,8084,20,0,32,31,83
150,8245,19,0,37,27,83
151,8274,20,0,37,26,83
152,8086,20,0,40,23,83
153,8295,20,0,40,23,83
154,8271,19,0,30,33,82
155,8212,20,0,34,28,82
156,8074,20,0,36,26,82
157,8104,20,0,41,21,82
158,8071,20,0,31,30,81
159,8148,20,0,37,24,81
160,8233,20,0,25,35,80
161,8185,17,0,33,30,80
162,8241,18,0,33,29,80
163,8092,19,0,33,28,80
164,8003,20,0,35,25,80
165,8037,20,0,38,22,80
166,8001,20,0,41,18,79
167,8068,19,0,27,32,78
"168.-169,",8066,20,0,28,30,78
168.-169.,8247,20,0,28,30,78
170.-171.,8064,20,0,31,27,78
170.-171.,8224,20,0,31,27,78
172,8144,20,0,32,26,78
173,8030,20,0,34,24,78
174,8179,18,0,37,23,78
175,8290,19,0,23,35,77
176,8105,19,0,26,32,77
177,8061,20,0,27,30,77
178,8250,20,0,28,29,77
179,8002,19,0,31,27,77
180,8253,20,0,30,27,77
181,8103,18,0,26,32,76
182,8287,19,0,31,26,76
183,8216,20,0,35,21,76
184,8111,19,0,19,37,75
185,8129,20,0,25,30,75
186,8227,20,0,41,14,75
187,8269,19,0,26,29,74
188,8311,19,0,26,29,74
189,8177,20,0,28,26,74
190,8020,20,0,29,25,74
191,8206,20,0,33,21,74
192,8276,19,0,24,30,73
193,8169,18,0,26,29,73
194,8116,20,0,29,24,73
195,8149,20,0,40,13,73
196,8231,20,0,24,28,72
197,8217,20,0,27,25,72
198,8310,19,0,29,24,72
199,8122,20,0,29,23,72
200.-201.,8062,20,0,26,25,71
200.-201.,8106,20,0,26,25,71
202,8248,20,0,28,23,71
203,8056,17,0,25,28,70
204,8242,16,0,27,27,70
205,8266,16,0,27,27,70
206,8112,20,0,28,22,70
207,8024,19,0,33,18,70
208,8059,18,0,21,30,69
209,8095,18,0,24,27,69
"210,",8303,18,0,26,25,69
211,8281,16,0,32,21,69
212,8121,20,0,30,19,69
213,8072,18,0,19,31,68
214,8163,20,0,24,24,68
215,8175,16,0,20,31,67
216,8085,20,0,24,23,67
217,8170,15,0,22,29,66
218,8178,18,0,19,29,66
219,8243,20,0,27,19,66
220,8226,20,0,29,17,66
221,8025,20,0,20,25,65
222,8031,20,0,24,21,65
223,8293,20,0,24,20,64
224,8259,20,0,25,19,64
225,8126,20,0,30,14,64
226,8260,19,0,11,33,63
227,8152,18,0,20,25,63
228,8143,20,0,24,19,63
229,8052,18,0,15,29,62
230,8164,17,0,19,26,62
231,8125,20,0,21,21,62
232,8301,19,0,23,20,62
233,8081,18,0,25,19,62
234,8267,20,0,27,15,62
235,8026,20,0,21,20,61
236,8228,19,0,24,18,61
237,8249,20,0,12,28,60
238,8012,20,0,24,16,60
239,8034,19,0,27,14,60
240,8244,20,0,30,10,60
241,8171,20,0,23,16,59
242,8294,14,0,24,20,58
243,8225,20,0,20,18,58
244,8150,17,0,15,25,57
245,8117,17,0,21,19,57
246,8043,17,0,13,26,56
247,8194,20,0,14,22,56
248,8100,20,0,19,17,56
249,8203,20,0,21,15,56
250,8049,20,0,23,13,56
251,8205,19,0,17,19,55
252,8136,19,0,19,17,55
"253,",8187,18,0,21,16,55
254,8147,20,0,22,13,55
255,8094,12,0,25,17,54
256,8158,19,0,19,16,54
257,8213,20,0,22,12,54
258,8298,20,0,18,15,53
259,8288,20,0,18,15,53
260,8193,17,0,23,13,53
261,8134,18,0,23,12,53
262,8219,19,0,32,2,53
263,8082,19,0,15,18,52
264,8079,20,0,15,17,52
265,8190,19,0,23,10,52
266,8236,19,0,11,21,51
267,8188,18,0,13,19,50
268,8142,18,0,14,18,50
269,8014,18,0,20,12,50
270,8282,19,0,19,12,50
271,8045,18,0,19,11,48
272,8292,16,0,22,9,47
273,8083,16,0,15,15,46
274,8306,11,0,18,16,45
275,8123,19,0,17,9,45
276,8189,18,0,19,8,45
277,8186,19,0,14,10,43
278,8221,19,0,15,9,43
279,8285,19,0,16,8,43
280,8018,15,0,13,14,42
281,8258,16,0,12,14,42
282,8254,16,0,13,13,42
283,8054,19,0,10,13,42
284,8133,15,0,18,9,42
285,8255,17,0,17,8,42
286,8145,17,0,12,12,41
287,8070,16,0,15,10,41
288,8172,17,0,14,9,40
289,8017,15,0,20,5,40
290,8097,15,0,14,10,39
291,8202,17,0,13,9,39
292,8280,19,0,12,8,39
293,8199,15,0,12,11,38
294,8304,15,0,7,12,34
295,8299,15,0,13,5,33
296,8268,19,0,4,9,32
297,8257,16,0,12,4,32
298,8283,18,0,11,1,30
299,8305,13,0,9,7,29
300,8289,19,0,6,0,25